"filename", "language", "XML", "Java", "comment", "blank", "total"
"e:\android\projects\project\app\src\main\AndroidManifest.xml", "XML", 39, 0, 0, 7, 46
"e:\android\projects\project\app\src\main\java\com\example\project\AboutUsActivity.java", "Java", 0, 47, 0, 9, 56
"e:\android\projects\project\app\src\main\java\com\example\project\DetectResultActivity.java", "Java", 0, 21, 0, 6, 27
"e:\android\projects\project\app\src\main\java\com\example\project\MainActivity.java", "Java", 0, 173, 22, 29, 224
"e:\android\projects\project\app\src\main\java\com\example\project\UploadBottomDialog.java", "Java", 0, 56, 1, 13, 70
"e:\android\projects\project\app\src\main\java\com\example\project\adapter\LinearHistoryItemAdapter.java", "Java", 0, 76, 5, 17, 98
"e:\android\projects\project\app\src\main\java\com\example\project\entity\TestFrameA.java", "Java", 0, 11, 0, 4, 15
"e:\android\projects\project\app\src\main\java\com\example\project\fragment\DetectFragment.java", "Java", 0, 128, 164, 16, 308
"e:\android\projects\project\app\src\main\java\com\example\project\fragment\HistoryFragment.java", "Java", 0, 45, 2, 9, 56
"e:\android\projects\project\app\src\main\java\com\example\project\fragment\HomeFragment.java", "Java", 0, 130, 5, 22, 157
"e:\android\projects\project\app\src\main\java\com\example\project\utils\AppConfig.java", "Java", 0, 15, 0, 7, 22
"e:\android\projects\project\app\src\main\java\com\example\project\utils\Base64BitmapUtil.java", "Java", 0, 38, 0, 8, 46
"e:\android\projects\project\app\src\main\java\com\example\project\utils\DataManageUtil.java", "Java", 0, 86, 6, 18, 110
"e:\android\projects\project\app\src\main\java\com\example\project\utils\OkhttpUtil.java", "Java", 0, 11, 0, 7, 18
"e:\android\projects\project\app\src\main\java\com\example\project\utils\UIUtil.java", "Java", 0, 9, 0, 4, 13
"e:\android\projects\project\app\src\main\res\drawable-v24\ic_launcher_foreground.xml", "XML", 30, 0, 0, 0, 30
"e:\android\projects\project\app\src\main\res\drawable\baseline_arrow_back_black_24dp.xml", "XML", 4, 0, 0, 1, 5
"e:\android\projects\project\app\src\main\res\drawable\baseline_arrow_back_grey_24dp.xml", "XML", 4, 0, 0, 1, 5
"e:\android\projects\project\app\src\main\res\drawable\baseline_history_blue_500_24dp.xml", "XML", 4, 0, 0, 1, 5
"e:\android\projects\project\app\src\main\res\drawable\baseline_photo_camera_blue_500_24dp.xml", "XML", 5, 0, 0, 1, 6
"e:\android\projects\project\app\src\main\res\drawable\divider_grey_1dp.xml", "XML", 9, 0, 0, 0, 9
"e:\android\projects\project\app\src\main\res\drawable\ic_launcher_background.xml", "XML", 170, 0, 0, 1, 171
"e:\android\projects\project\app\src\main\res\drawable\ic_view_in_ar_black_24dp.xml", "XML", 21, 0, 0, 1, 22
"e:\android\projects\project\app\src\main\res\drawable\round_add_black_24dp.xml", "XML", 4, 0, 0, 1, 5
"e:\android\projects\project\app\src\main\res\drawable\round_folder_open_black_24dp.xml", "XML", 4, 0, 0, 1, 5
"e:\android\projects\project\app\src\main\res\drawable\round_home_blue_500_24dp.xml", "XML", 4, 0, 0, 1, 5
"e:\android\projects\project\app\src\main\res\drawable\round_image_black_24dp.xml", "XML", 4, 0, 0, 1, 5
"e:\android\projects\project\app\src\main\res\layout\activity_about_us.xml", "XML", 74, 0, 2, 14, 90
"e:\android\projects\project\app\src\main\res\layout\activity_detect_result.xml", "XML", 35, 0, 2, 10, 47
"e:\android\projects\project\app\src\main\res\layout\activity_main.xml", "XML", 46, 0, 2, 9, 57
"e:\android\projects\project\app\src\main\res\layout\fragment_detect.xml", "XML", 101, 0, 1, 12, 114
"e:\android\projects\project\app\src\main\res\layout\fragment_history.xml", "XML", 37, 0, 1, 6, 44
"e:\android\projects\project\app\src\main\res\layout\fragment_home.xml", "XML", 69, 0, 1, 8, 78
"e:\android\projects\project\app\src\main\res\layout\history_item.xml", "XML", 105, 0, 2, 11, 118
"e:\android\projects\project\app\src\main\res\layout\photo_view_preview.xml", "XML", 16, 0, 0, 2, 18
"e:\android\projects\project\app\src\main\res\layout\upload_bottom_dialog.xml", "XML", 30, 0, 0, 2, 32
"e:\android\projects\project\app\src\main\res\menu\bottom_navigation_menu.xml", "XML", 13, 0, 0, 0, 13
"e:\android\projects\project\app\src\main\res\menu\main_toolbar_menu.xml", "XML", 16, 0, 0, 1, 17
"e:\android\projects\project\app\src\main\res\mipmap-anydpi-v26\ic_launcher.xml", "XML", 5, 0, 0, 0, 5
"e:\android\projects\project\app\src\main\res\mipmap-anydpi-v26\ic_launcher_round.xml", "XML", 5, 0, 0, 0, 5
"e:\android\projects\project\app\src\main\res\values-night\themes.xml", "XML", 11, 0, 5, 0, 16
"e:\android\projects\project\app\src\main\res\values\colors.xml", "XML", 32, 0, 0, 5, 37
"e:\android\projects\project\app\src\main\res\values\strings.xml", "XML", 22, 0, 1, 0, 23
"e:\android\projects\project\app\src\main\res\values\themes.xml", "XML", 17, 0, 5, 2, 24
"e:\android\projects\project\app\src\main\res\xml\file_paths.xml", "XML", 4, 0, 0, 0, 4
"e:\android\projects\project\app\src\main\res\xml\network_security_config.xml", "XML", 4, 0, 0, 0, 4
"Total", "-", 944, 846, 227, 268, 2285